"UNCLE" VITO E. MARANZANO GLENDALE PLAYGROUND	1,value
100% PLAYGROUND	5,value
5TH ST SLOPE GARDEN	1,value
A PHILIP RANDOLPH SQUARE	1,value
ABE LEBEWOHL PARK	3,value
ABIGAIL PLAYGROUND	2,value
ABINGDON SQUARE	1,value
ABRAHAM LINCOLN PLAYGROUND	3,value
ADAM CLAYTON POWELL JR. MALLS	1,value
ADAM YAUCH PARK	1,value
ADMIRAL FARRAGUT PLAYGROUND	3,value
AGNES HAYWOOD PLAYGROUND	3,value
AHEARN PARK	1,value
ALBEMARLE PLAYGROUND	1,value
ALBEN TRIANGLE	1,value
ALBERT J. PARHAM PLAYGROUND	1,value
ALEXANDER HAMILTON PLAYGROUND	1,value
ALFRED E. SMITH PLAYGROUND	2,value
ALICE AUSTEN PARK	1,value
ALICE KORNEGAY TRIANGLE	5,value
ALLEN MALL ONE	4,value
ALLERTON PLAYGROUND	4,value
ALLEY PARK	7,value
ALLEY POND PARK	11,value
ALMEDA PLAYGROUND	4,value
AMERICAN PLAYGROUND	2,value
AMERICAN TRIANGLE	1,value
AMERICAN VETERANS MEMORIAL PIER	1,value
AMERSFORT PARK	16,value
AMPERE PLAYGROUND	1,value
ANDREWS GROVE	1,value
ANDRIES PLAYGROUND	1,value
ANIBAL AVILES PLAYGROUND	1,value
ANNADALE PLAYGROUND	1,value
ANNUNCIATION PARK	1,value
AQUEDUCT WALK	38,value
ARCILLA PLAYGROUND	12,value
ARROCHAR PLAYGROUND	1,value
ARVERNE PLAYGROUND	1,value
ASPHALT GREEN	3,value
ASSER LEVY PARK	8,value
ASSER LEVY PLAYGROUND	6,value
ASTORIA HEIGHTS PLAYGROUND	12,value
ASTORIA PARK	27,value
ATHENS SQUARE	1,value
AUDUBON PLAYGROUND	1,value
BAILEY PLAYGROUND	1,value
BAISLEY POND PARK	36,value
BANNEKER PLAYGROUND	1,value
BARRETTO PARK	1,value
BARRETTO POINT PARK	2,value
BARTEL-PRITCHARD SQUARE	1,value
BARTLETT PLAYGROUND	5,value
BARUCH PLAYGROUND	2,value
BATH BEACH PARK	10,value
BATHGATE PLAYGROUND	4,value
BATTERY PARK	44,value
BATTERY PARK CITY	30,value
BAY TERRACE PLAYGROUND	1,value
BAYSWATER PARK	2,value
BAYVIEW PLAYGROUND	2,value
BEACH 30TH STREET PLAYGROUND	1,value
BEACH 9 PLAYGROUND	5,value
BEACH CHANNEL PLAYGROUND	2,value
BEANSTALK PLAYGROUND	2,value
BEATTY PLAZA	1,value
BEDFORD PLAYGROUND	2,value
BEHAGEN PLAYGROUND	10,value
BELLAIRE PLAYGROUND	1,value
BELLEVUE SOUTH PARK	3,value
BELMONT PLAYGROUND BRONX	10,value
BELMONT PLAYGROUND BROOKLYN	3,value
BELT PARKWAY/SHORE PARKWAY	12,value
BENJAMIN GLADSTONE SQUARE	2,value
BENNETT PARK	3,value
BENNINGER PLAYGROUND	1,value
BENSON PLAYGROUND	1,value
BENSONHURST PARK	6,value
BERGEN BEACH PLAYGROUND	1,value
BETSY HEAD PARK	22,value
BICENTENNIAL VETERANS MEMORIAL PARK	1,value
BIG BUSH PARK	1,value
BILDERSEE PLAYGROUND	2,value
BILL BOJANGLES ROBINSON PLAYGROUND	2,value
BILL BROWN PLAYGROUND	4,value
BLAKE HOBBS PLAYGROUND	2,value
BLAND PLAYGROUND	5,value
BLOOMINGDALE PARK	3,value
BOERUM PARK	1,value
BOOKER T. WASHINGTON PLAYGROUND	8,value
BOWLING GREEN	1,value
BOWNE PARK	17,value
BOWNE PLAYGROUND	7,value
BRADHURST URBAN RENEWAL PARK	2,value
BREININGER PARK	3,value
BREUKELEN BALLFIELDS	1,value
BRIARWOOD PLAYGROUND	1,value
BRIDGE PARK 3	4,value
BRIDGE PARK BROOKLYN	12,value
BRIDGE PLAYGROUND	1,value
BRIGHTON PLAYGROUND	2,value
BRIZZI PLAYGROUND	1,value
BROADWAY MALLS	6,value
BRONX PARK	49,value
BRONX RIVER PARKWAY	17,value
BROOK PARK	1,value
BROOKLYN BOTANIC GARDEN	3,value
BROOKLYN BRIDGE PARK	45,value
BROOKLYN HEIGHTS PROMENADE	1,value
BROOKLYN MUSEUM	3,value
BROOKVILLE PARK	8,value
BROWER PARK	14,value
BROWNSVILLE PLAYGROUND	6,value
BRUST PARK	1,value
BRYAN PARK	1,value
BRYANT PARK	69,value
BRYANT TRIANGLE	1,value
BUFANO PARK	5,value
BULOVA PARK	1,value
BURNS PLAYGROUND	1,value
BUSHWICK INLET PARK	8,value
BUSHWICK PLAYGROUND ON FLUSHING AVENUE	1,value
BUSHWICK PLAYGROUND ON KNICKERBOCKER AVENUE	8,value
CADMAN PLAZA PARK	5,value
CALLAHAN-KELLY PLAYGROUND	9,value
CALVERT VAUX PARK	24,value
CAMBRIA PLAYGROUND	2,value
CANARSIE PARK	15,value
CAPTAIN DERMODY TRIANGLE	1,value
CAPTAIN JACOB JOSEPH PLAYGROUND	1,value
CAPTAIN RIVERA PLAYGROUND	13,value
CAPTAIN TILLY PARK	15,value
CARL SCHURZ PARK	15,value
CARMANSVILLE PLAYGROUND	4,value
CARROLL PARK	9,value
CARVER PLAYGROUND	3,value
CASERTA PLAYGROUND	3,value
CASTLE HILL PARK	2,value
CASTLE HILL PLAYGROUND	2,value
CATHERINE SLIP MALLS	3,value
CEDAR PLAYGROUND	3,value
CENTRAL PARK	543,value
CENTREVILLE PLAYGROUND	2,value
CENTURY PLAYGROUND	1,value
CHALLENGE PLAYGROUND	1,value
CHELSEA PARK	30,value
CHELSEA RECREATION CENTER	12,value
CHERRY CLINTON PLAYGROUND	2,value
CHERRY TREE PARK	4,value
CHESTER PLAYGROUND	7,value
CHIARANTANO PLAYGROUND	1,value
CHIEF DENNIS L. DEVLIN PARK	11,value
CHRISTOPHER PARK	4,value
CICCARONE PARK	1,value
CITY HALL PARK	4,value
CITY ISLAND WETLANDS	1,value
CITY LINE PARK	5,value
CLAREMONT NEIGHBORHOOD GARDEN	1,value
CLAREMONT PARK	134,value
CLARK PLAYGROUND	2,value
CLASSON PLAYGROUND AT CLASSON AVENUE & LAFAYETTE AVENUE	3,value
CLINTON COMMUNITY GARDEN	1,value
CLINTONVILLE PLAYGROUND	2,value
CLOVE LAKES PARK	11,value
COBBLE HILL PARK	1,value
COFFEY PARK	6,value
COL. YOUNG PLAYGROUND	15,value
COLDEN PLAYGROUND	2,value
COLEMAN PLAYGROUND	18,value
COLGATE CLOSE	1,value
COLLECT POND PARK	1,value
COLLEGE POINT FIELDS	1,value
COLLEGE POINT PARK	3,value
COLONEL CHARLES YOUNG TRIANGLE	4,value
COLONEL DAVID MARCUS PLAYGROUND	3,value
COLUCCI PLAYGROUND	3,value
COLUMBUS PARK AT MANHATTAN	15,value
COMMODORE BARRY PARK	15,value
CONCRETE PLANT PARK	17,value
CONEY ISLAND BEACH & BOARDWALK	136,value
CONEY ISLAND BOAT BASIN	1,value
CONEY ISLAND CREEK PARK	3,value
CONFERENCE HOUSE PARK	6,value
CONTINENTAL ARMY PLAZA	1,value
COOPER PARK	5,value
CORLEARS HOOK PARK	1,value
CORONA GOLF PLAYGROUND	6,value
CORONA MAC PARK	3,value
CORPORAL JOHN A. SERAVALLI PLAYGROUND	2,value
CORPORAL WILTSHIRE SQUARE	1,value
COURTNEY CALLENDER PLAYGROUND	2,value
CPL. THOMPSON PARK	7,value
CRACK IS WACK PLAYGROUND	4,value
CRISPUS ATTUCKS PLAYGROUND	3,value
CROCHERON PARK	4,value
CROTONA PARK	104,value
CROTONA PARKWAY MALLS	3,value
CROWLEY PLAYGROUND	5,value
CUNNINGHAM PARK	4,value
CURTIS PLAYGROUND	1,value
CYPRESS HILLS PLAYGROUND	3,value
D'AURIA-MURPHY TRIANGLE	1,value
D'EMIC PLAYGROUND	1,value
DANIEL M. O'CONNELL PLAYGROUND	7,value
DANTE PARK	1,value
DAVIDSON PLAYGROUND	1,value
DAWSON PLAYGROUND	5,value
DE COLORES COMMUNITY YARD AND CULTURAL CENTER	2,value
DE HOSTOS PLAYGROUND	6,value
DE MATTI PLAYGROUND	2,value
DE WITT CLINTON PARK	7,value
DEAN PLAYGROUND	5,value
DECATUR PLAYGROUND	2,value
DETECTIVE JOSEPH MAYROSE PARK	2,value
DETECTIVE KEITH L WILLIAMS PARK	7,value
DETECTIVE WILLIAM T. GUNN PARK	1,value
DEVANNEY TRIANGLE	4,value
DEVOE PARK	18,value
DI GILIO PLAYGROUND	2,value
DITMARS PARK	6,value
DODGER PLAYGROUND	2,value
DOME PLAYGROUND	3,value
DONGAN PLAYGROUND	2,value
DOUGHBOY PLAZA	4,value
DOWNING STREET PLAYGROUND	2,value
DR. CHARLES R. DREW PARK	1,value
DR. GERTRUDE B. KELLY PLAYGROUND	3,value
DR. RONALD E. MCNAIR PLAYGROUND	8,value
DR. RONALD MCNAIR PARK	1,value
DREW PLAYGROUND	4,value
DRUMM TRIANGLE	1,value
DUANE PARK	1,value
DUGAN PLAYGROUND	3,value
DUKE PARK	1,value
DUNBAR PLAYGROUND	2,value
DUTCH KILLS PLAYGROUND	11,value
DWYER SQUARE	1,value
DYCKMAN HOUSE MUSEUM	1,value
DYKER BEACH PARK	24,value
EACH ONE TEACH ONE	1,value
EAGLE SLOPE	1,value
EAST ELMHURST PLAYGROUND	5,value
EAST NEW YORK FARMS GARDEN	1,value
EAST RIVER ESPLANADE AT E 36TH ST AND FDR	1,value
EAST RIVER ESPLANADE E 90TH ST TO E 125TH ST	2,value
EAST RIVER PARK	64,value
EAST RIVER PLAYGROUND	10,value
EAST RIVER WALK	2,value
EAST RIVER WATERFRONT ESPLANADE	12,value
EASTCHESTER PLAYGROUND	2,value
EASTERN PARKWAY	8,value
ECHO TRIANGLE	19,value
EDENWALD PLAYGROUND	1,value
EDMONDS PLAYGROUND	3,value
EHRENREICH-AUSTIN PLAYGROUND	1,value
EL JARDIN DEL PARAISO PARK	1,value
ELEANOR ROOSEVELT PLAYGROUND	1,value
ELMHURST PARK	9,value
ELTON PLAYGROUND	17,value
EMERALD PLAYGROUND	2,value
ENNIS PLAYGROUND	3,value
EPIPHANY PLAYGROUND	4,value
EQUITY PARK	7,value
ESTELLA DIGGS PARK	5,value
ETHAN ALLEN PLAYGROUND	2,value
EVERGREEN PARK	4,value
EVERGREEN PLAYGROUND	1,value
EWEN PARK	21,value
FABER POOL AND PARK	2,value
FAIRMOUNT PLAYGROUND	9,value
FATHER DUFFY SQUARE	6,value
FERMI PLAYGROUND	1,value
FERRY POINT PARK	17,value
FIRST PARK	2,value
FISH PLAYGROUND	5,value
FLOYD PATTERSON BALLFIELDS	2,value
FLUSHING FIELDS	2,value
FLUSHING MEADOWS CORONA PARK	301,value
FLYNN PLAYGROUND	4,value
FORDHAM BEDFORD LOT BUSTERS	1,value
FORDHAM LANDING PLAYGROUND	1,value
FOREST PARK	29,value
FORT GREENE PARK	47,value
FORT HAMILTON ATHLETIC FIELD	4,value
FORT INDEPENDENCE PLAYGROUND	1,value
FORT TOTTEN PARK	1,value
FORT TRYON PARK	41,value
FORT WASHINGTON PARK	19,value
FOUNTAIN OF YOUTH PLAYGROUND	2,value
FOX PLAYGROUND BRONX	8,value
FOX PLAYGROUND BROOKLYN	7,value
FRANCIS LEWIS PARK	2,value
FRANK D. O'CONNOR PLAYGROUND	6,value
FRANK GOLDEN PARK	1,value
FRANK PRINCIPE PARK	2,value
FRANKLIN D. ROOSEVELT BOARDWALK AND BEACH	8,value
FRANZ SIGEL PARK	55,value
FRED SAMUEL PLAYGROUND	7,value
FREDERICK B. JUDGE PLAYGROUND	1,value
FREDERICK DOUGLASS PLAYGROUND	22,value
FREDERICK JOHNSON PLAYGROUND	2,value
FRESH MEADOWS PLAYGROUND	1,value
FRIENDS FIELD	10,value
FRONTERA PARK	3,value
FULTON PARK	14,value
GALAPO PLAYGROUND	2,value
GALILEO PLAYGROUND	2,value
GARDEN AT MOORSE STREET	1,value
GARDEN PLAYGROUND	2,value
GARIBALDI PLAYGROUND	1,value
GEORGE WALKER JR. PARK	1,value
GERTRUDE EDERLE RECREATION CENTER	2,value
GIVANS CREEK WOODS	1,value
GLENWOOD PLAYGROUND	1,value
GOBLE PLAYGROUND	6,value
GORMAN PARK	7,value
GORMAN PLAYGROUND	5,value
GOUVERNEUR PLAYGROUND	5,value
GRACE PLAYGROUND	5,value
GRADY PLAYGROUND	3,value
GRAND ARMY PLAZA BROOKLYN	2,value
GRAND CENTRAL PARKWAY	2,value
GRAND FERRY PARK	1,value
GRAND PLAYGROUND	1,value
GRANT PARK	14,value
GRAVESEND PARK	11,value
GREAT KILLS PARK	6,value
GREELEY SQUARE PARK	6,value
GREENE PLAYGROUND	1,value
GREENPOINT PLAYGROUND	1,value
GROVE HILL PLAYGROUND	3,value
GROVER CLEVELAND PLAYGROUND	4,value
GUN HILL PLAYGROUND	4,value
HAFFEN PARK	8,value
HAGGERTY PARK	3,value
HALF-NELSON PLAYGROUND	4,value
HALLETS COVE PLAYGROUND	2,value
HAMILTON FISH PARK	8,value
HAMILTON METZ FIELD	9,value
HANCOCK T AND T	1,value
HANSBOROUGH RECREATION CENTER	1,value
HAPPY WARRIOR PLAYGROUND	5,value
HARDING PARK	4,value
HARLEM ART PARK	10,value
HARLEM LANE PLAYGROUND	1,value
HARLEM RIVER PARK	88,value
HAROLD SCHNEIDERMAN PLAYGROUND	1,value
HARRIS PARK	8,value
HART PLAYGROUND ON 147 ST	1,value
HART PLAYGROUND ON BROADWAY	4,value
HARVARD PLAYGROUND	2,value
HARVEY PARK	1,value
HATTIE CARTHAN PLAYGROUND	1,value
HAVEMEYER PLAYGROUND	1,value
HAVEN AVENUE	4,value
HELL'S KITCHEN PARK	5,value
HENRY HUDSON PARK	2,value
HERALD SQUARE	8,value
HERBERT VON KING PARK	23,value
HERMAN DOLGON PLAYGROUND	1,value
HIGH ROCK PARK	1,value
HIGHBRIDGE PARK BRONX SIDE	5,value
HIGHBRIDGE PARK MANHATTAN SIDE	62,value
HIGHLAND PARK	33,value
HINES PARK	3,value
HINTON PARK	3,value
HOFFMAN PARK	16,value
HOLCOMBE RUCKER PARK	9,value
HOLLIS PLAYGROUND	2,value
HOMECREST PLAYGROUND	7,value
HOOVER - MANTON PLAYGROUNDS	1,value
HOPE BALLFIELD	1,value
HORACE HARDING PLAYGROUND	2,value
HORSESHOE PLAYGROUND	3,value
HOUSTON PLAYGROUND	5,value
HOWARD BENNETT PLAYGROUND	4,value
HOWARD PLAYGROUND	8,value
HOWARD POOL	2,value
HOWARD VON DOHLEN PLAYGROUND	2,value
HOYT PLAYGROUND	7,value
HUNTER'S POINT SOUTH PARK	5,value
HUNTS POINT PLAYGROUND	9,value
HUNTS POINT RIVERSIDE PARK	1,value
IDLEWILD PARK	6,value
IMAGINATION PLAYGROUND	2,value
INWOOD HILL PARK	20,value
INWOOD PARK	7,value
IRVING SQUARE PARK	2,value
ISHAM PARK	1,value
J. HOOD WRIGHT PARK	10,value
J.J. BYRNE PLAYGROUND	4,value
JACKIE ROBINSON COMMUNITY GARDEN	1,value
JACKIE ROBINSON PARK BROOKLYN	1,value
JACKIE ROBINSON PARK MANHATTAN	46,value
JACKIE ROBINSON PARKWAY	1,value
JACKIE ROBINSON PLAYGROUND	9,value
JACKSON SQUARE	1,value
JACOB H. SCHIFF PLAYGROUND	16,value
JACOB JOFFE FIELDS	9,value
JAIME CAMPIZ PLAYGROUND	1,value
JAMAICA BAY PARK	1,value
JAMAICA PLAYGROUND	9,value
JAMES J WALKER PARK	4,value
JAMES WELDON JOHNSON PLAYGROUND	10,value
JEROME PARK	2,value
JEROME PLAYGROUND	3,value
JEROME PLAYGROUND SOUTH	1,value
JEROME SLOPE	1,value
JESSE OWENS PLAYGROUND	1,value
JOHN HANCOCK PLAYGROUND	2,value
JOHN J CARTY PARK	4,value
JOHN JAY PARK	5,value
JOHN VINCENT DANIELS JR. SQUARE	1,value
JOSEPH AUSTIN PLAYGROUND	2,value
JOSEPH RODMAN DRAKE PARK	1,value
JOYCE KILMER PARK	29,value
JUDGE MOSES WEINSTEIN PLAYGROUND	1,value
JULIO CARBALLO FIELDS	1,value
JUNCTION PLAYGROUND	6,value
JUNIPER VALLEY PARK	14,value
KAISER PARK	11,value
KELLY PARK	14,value
KELTCH PARK	1,value
KISSENA CORRIDOR PARK	5,value
KISSENA PARK	13,value
KOLBERT PLAYGROUND	5,value
KOREAN WAR VETERANS PLAZA	1,value
KOSCIUSZKO POOL	3,value
L/CPL THOMAS P. NOONAN JR. PLAYGROUND	1,value
LA GUARDIA PLAYGROUND	1,value
LAFAYETTE PLAYGROUND ON LAFAYETTE AVENUE	1,value
LAGUARDIA LANDING LIGHTS	3,value
LATIMER PLAYGROUND	1,value
LATOURETTE PARK & GOLF COURSE	2,value
LAURELTON PLAYGROUND	2,value
LAWRENCE VIRGILIO PLAYGROUND	4,value
LEFFERTS PLAYGROUND	1,value
LEIF ERICSON FIELDS	1,value
LEIF ERICSON PARK	7,value
LEWIS H LATIMER HOUSE	1,value
LEWIS PLAYGROUND	1,value
LIEUTENANT JOHN H. MARTINSON PLAYGROUND	1,value
LINCOLN RD BLOCK ASSOCIATION	4,value
LINCOLN TERRACE / ARTHUR S. SOMERS PARK	42,value
LINDEN PARK	19,value
LINDOWER PARK	2,value
LINDSAY TRIANGLE	10,value
LINWOOD PLAYGROUND	1,value
LITTLE BAY PARK	2,value
LITTLE FLOWER PLAYGROUND	1,value
LIVONIA PARK	3,value
LONDON PLANETREE PLAYGROUND	10,value
LONG POND PARK	1,value
LOPEZ PLAYGROUND	1,value
LORETO PLAYGROUND	4,value
LOTT PARK	1,value
LOUIS ARMSTRONG PLAYGROUND	3,value
LOUIS PASTEUR PARK	1,value
LOZADA PLAYGROUND	3,value
LT. JOSEPH PETROSINO PARK	10,value
LT. LIA PLAYGROUND	5,value
LUNA PARK	19,value
LUTHER GULICK PLAYGROUND	2,value
LYONS POOL	1,value
LYONS SQUARE PLAYGROUND	7,value
MACDONALD PARK	2,value
MACLAUGHLIN PLAYGROUND	1,value
MACNEIL PARK	2,value
MACOMBS DAM PARK	122,value
MADISON COMMUNITY GREENTHUMB	3,value
MADISON SQUARE PARK	13,value
MAFERA PARK	7,value
MAGENTA PLAYGROUND	3,value
MAHONEY PLAYGROUND	1,value
MAJOR MARK PARK	4,value
MANHATTAN BEACH PARK	7,value
MANOR PARK	1,value
MAPLE PLAYGROUND	9,value
MARBLE HILL PLAYGROUND	3,value
MARC AND JASON'S PLAYGROUND	7,value
MARCONI PARK	1,value
MARCUS GARVEY PARK	137,value
MARCY GREEN SOUTH	1,value
MARCY PARK SOUTH	1,value
MARCY PLAYGROUND	4,value
MARIA HERNANDEZ PARK	43,value
MARIE CURIE PARK	2,value
MARINE PARK	20,value
MARINERS HARBOR PLAYGROUND	2,value
MARION HOPKINSON PLAYGROUND	4,value
MARKHAM PLAYGROUND	1,value
MARLBORO PLAYGROUND	3,value
MARTIN LUTHER KING JR. PLAYGROUND	7,value
MARTIN LUTHER KING PLAYGROUND	5,value
MARTIN LUTHER PLAYGROUND	2,value
MATTHEWS - PALMER PLAYGROUND	18,value
MATTHEWS MULINER PLAYGROUND	4,value
MAURICE A FITZGERALD PLAYGROUND	6,value
MCCAFFREY PLAYGROUND	8,value
MCCARREN PARK	58,value
MCDONALD PLAYGROUND BROOKLYN	4,value
MCDONALD PLAYGROUND STATEN ISLAND	1,value
MCGUIRE FIELDS	2,value
MCKINLEY PARK	12,value
MCKINLEY PLAYGROUND	1,value
MCKINLEY SQUARE	2,value
MCLAUGHLIN PARK	5,value
MELLETT PLAYGROUND	2,value
MELROSE PLAYGROUND	1,value
MERCER PLAYGROUND	5,value
MERRIAM PLAYGROUND	29,value
METRO TRIANGLE	1,value
MIDDLETON PLAYGROUND	3,value
MIDLAND FIELD	1,value
MIDLAND PLAYGROUND	2,value
MILESTONE PARK	4,value
MILL POND PARK	3,value
MILLBROOK PLAYGROUND	1,value
MINETTA TRIANGLE	1,value
MITCHEL SQUARE	1,value
MONSIGNOR KETT PLAYGROUND	4,value
MONTBELLIER PARK	2,value
MOORE HOMESTEAD PLAYGROUND	22,value
MOORE PLAYGROUND	8,value
MORNINGSIDE PARK	55,value
MORRIS GARDEN	2,value
MORRIS MESA	1,value
MOSHOLU PARKWAY	25,value
MOSHOLU PLAYGROUND	5,value
MOTT PLAYGROUND	13,value
MOUNT HOPE GARDEN	1,value
MOUNT HOPE PLAYGROUND	6,value
MOUNT PROSPECT PARK	3,value
MSGR. MCGOLRICK PARK	10,value
MULLALY PARK	83,value
MURPHY'S BROTHER'S PLAYGROUND	1,value
MURRAY HILL PLAYGROUND	1,value
MURRAY PLAYGROUND	7,value
NATHAN STRAUS PLAYGROUND	3,value
NAUTILUS PLAYGROUND QUEENS	1,value
NEHEMIAH PARK	2,value
NEIGHBORS OF VEGA BAJA	1,value
NELSON PLAYGROUND	6,value
NEPONSIT MALL	1,value
NEPTUNE PLAYGROUND	3,value
NEW DORP PARK	1,value
NEWPORT PLAYGROUND	2,value
NEWTOWN PLAYGROUND	1,value
NICHOLAS NAQUAN HEYWARD JR. PARK	5,value
NOBLE PLAYGROUND	4,value
NORTH 5TH STREET PIER AND PARK	2,value
NORTH ROCHDALE PLAYGROUND	1,value
NORTHERLEIGH PARK	2,value
NORTHERN PLAYGROUND	19,value
NOSTRAND PLAYGROUND	6,value
NULL	5093623,value
OAKLAND GARDENS	2,value
OCEAN BREEZE PARK	3,value
OCEAN HILL PLAYGROUND	3,value
OCEAN PARKWAY MALLS	1,value
OGDEN PLIMPTON PLAYGROUND	3,value
OLD TOWN PLAYGROUND	1,value
OPEN ROAD PARK	1,value
ORACLE PLAYGROUND	3,value
OSBORN PLAYGROUND	4,value
OWL'S HEAD PARK	18,value
P.O. REINALDO SALGADO PLAYGROUND	5,value
P.O. SERRANO PLAYGROUND	3,value
P.S. 125 PLAYGROUND	1,value
P.S. 149 ARTSY BLOOM COMMUNITY GARDEN	1,value
P.S. 155 PLAYGROUND	2,value
P.S. 279 PLAYGROUND	1,value
PAERDEGAT BASIN PARK	1,value
PAERDEGAT PARK	7,value
PARADE GROUND	42,value
PARK OF THE AMERICAS	17,value
PARK SLOPE PLAYGROUND	2,value
PARKSIDE PLAYGROUND BRONX	1,value
PARKSIDE PLAYGROUND BROOKLYN	12,value
PATTERSON PLAYGROUND	7,value
PAUL RAIMONDA PLAYGROUND	1,value
PECK SLIP	1,value
PELHAM BAY PARK	34,value
PELHAM PARKWAY	5,value
PENA HERRERA PARK	1,value
PENN SOUTH PLAYGROUND	10,value
PEOPLE'S PARK	8,value
PERETZ SQUARE	2,value
PETER MINUIT PLAYGROUND	1,value
PETERS FIELD	1,value
PETROSINO SQUARE	4,value
PHIL "SCOOTER" RIZZUTO PARK	3,value
PINK PLAYGROUND	2,value
PLANEVIEW PARK	1,value
PLAUT TRIANGLE	1,value
PLAYGROUND 103 CIII	4,value
PLAYGROUND 174	2,value
PLAYGROUND 52 LII	8,value
PLAYGROUND NINETY	5,value
PLAYGROUND ONE FORTY	1,value
PLAYGROUND ONE THIRTY FOUR CXXXIV	2,value
PLAYGROUND SEVENTY FIVE	1,value
PLAYGROUND TWENTY ONE	1,value
PLEASANT PARK GARDEN	1,value
PLIMPTON PLAYGROUND	11,value
POE PARK	5,value
POLICE OFFICER NICHOLAS DEMUTIIS PARK	3,value
PONTIAC PLAYGROUND	4,value
POOR RICHARD'S PLAYGROUND	6,value
POPPENHUSEN PARK	1,value
POSEIDON PLAYGROUND	2,value
POTOMAC PLAYGROUND	6,value
POWELL PLAYGROUND	5,value
POWER PLAYGROUND	3,value
PRATT PLAYGROUND	1,value
PRINTER'S PARK	3,value
PROSPECT PARK	87,value
PROSPECT PLAYGROUND	1,value
PUBLIC PLACE	2,value
PUGSLEY CREEK PARK	8,value
PULASKI PARK	4,value
PULASKI PLAYGROUND	4,value
QUARRY BALLFIELDS	14,value
QUEENS VILLAGE VETERANS PLAZA	2,value
QUEENSBRIDGE PARK	7,value
RAILROAD PARK BRONX	5,value
RAILROAD PLAYGROUND	1,value
RAINBOW PLAYGROUND	6,value
RAINEY PARK BRONX	38,value
RAINEY PARK QUEENS	7,value
RALPH DEMARCO PARK	1,value
RAMON APONTE PARK	7,value
RANAQUA PARK	1,value
RANDALL'S ISLAND PARK	81,value
RAOUL WALLENBERG FOREST	1,value
RAVENSWOOD PLAYGROUND	2,value
RAYMOND BUSH PLAYGROUND	7,value
REAL GOOD PARK	1,value
RECREATION CENTER 54	2,value
RECREATIONAL AREA	3,value
RED HOOK RECREATION AREA	9,value
REDFERN PLAYGROUND	2,value
REIFF PLAYGROUND	1,value
REMSEN PLAYGROUND	2,value
RENAISSANCE PLAYGROUND	2,value
RICHMAN (ECHO) PARK	19,value
RIENZI PLAYGROUND	2,value
RIVER AVENUE PARKS	17,value
RIVERDALE PLAYGROUND	1,value
RIVERSIDE PARK	188,value
ROBERT E. VENABLE PARK	8,value
ROBERTO CLEMENTE BALLFIELD	1,value
ROCHDALE PARK	3,value
ROCK GARDEN PARK	2,value
ROCKAWAY BEACH AND BOARDWALK	80,value
ROCKAWAY COMMUNITY PARK	1,value
ROCKAWAY FREEWAY	2,value
RODNEY PARK CENTER	1,value
RODNEY PARK NORTH	2,value
RODNEY PARK SOUTH	1,value
RODNEY PLAYGROUND NORTH	2,value
RODNEY PLAYGROUND SOUTH	1,value
ROEBLING PLAYGROUND	4,value
ROGER MORRIS PARK	1,value
ROLF HENRY PLAYGROUND	1,value
RORY STAUNTON FIELD	1,value
ROSE HILL PARK	1,value
ROSEMARY'S PLAYGROUND	8,value
ROY WILKINS RECREATION CENTER	19,value
RUFUS KING PARK	42,value
RUSSELL PEDERSEN PLAYGROUND	5,value
SAMUEL N. BENNERSON 2ND PLAYGROUND	2,value
SAMUEL SEABURY PLAYGROUND	3,value
SARA D. ROOSEVELT PARK	86,value
SARATOGA PARK	7,value
SARATOGA SQUARE URBAN RENEWAL AREA, SITE 164	2,value
SAW MILL PLAYGROUND	5,value
SCARANGELLA PARK	2,value
SCHENCK PLAYGROUND	5,value
SCHIFF MALL	1,value
SCHMUL PARK	1,value
SEAN'S PLACE	1,value
SEASIDE PLAYGROUND	1,value
SEASIDE WILDLIFE NATURE PARK	1,value
SEDGWICK PLAYGROUND	1,value
SETH LOW PLAYGROUND/ BEALIN SQUARE	9,value
SETON FALLS PARK	20,value
SETON PARK	12,value
SEWARD PARK	12,value
SHEEPSHEAD PLAYGROUND	3,value
SHELTERING ARMS PLAYGROUND	3,value
SHERIDAN SQUARE VIEWING GARDEN	1,value
SHERMAN CREEK	5,value
SHORE PARK AND PARKWAY	18,value
SILVER LAKE PARK	1,value
SIMEONE PARK	5,value
SIREN SLOPE	1,value
SIXTEEN SYCAMORES PLAYGROUND	2,value
SLATTERY PLAYGROUND	13,value
SLOPE PARK	1,value
SOCRATES SCULPTURE PARK	2,value
SOL BLOOM PLAYGROUND	3,value
SOUNDVIEW PARK	24,value
SOUTH BEACH WETLANDS	2,value
SOUTH PACIFIC PLAYGROUND	5,value
SOUTH ROCHDALE PLAYGROUND	2,value
SPACE TIME PLAYGROUND	5,value
SPERANDEO BROTHERS PLAYGROUND	3,value
SPIRIT PLAYGROUND	1,value
SPRINGFIELD PARK	10,value
SPUYTEN DUYVIL PLAYGROUND	1,value
ST. ALBANS PARK	3,value
ST. ANDREW'S PLAYGROUND	10,value
ST. CATHERINE'S PARK	3,value
ST. GREGORY'S PLAYGROUND	1,value
ST. JAMES PARK	65,value
ST. JOHN'S RECREATION CENTER	25,value
ST. LAWRENCE TRIANGLE	2,value
ST. MARY'S PARK BRONX	143,value
ST. MICHAEL'S PARK	13,value
ST. MICHAEL'S PLAYGROUND	7,value
ST. NICHOLAS MIRACLE GARDEN	1,value
ST. NICHOLAS PARK	85,value
ST. NICHOLAS PLAYGROUND NORTH	6,value
ST. NICHOLAS PLAYGROUND SOUTH	2,value
ST. VARTAN PARK	1,value
STANLEY ISAACS PLAYGROUND	4,value
STAPLETON PLAYGROUND	3,value
STAR SPANGLED PLAYGROUND	1,value
STARLIGHT PARK	11,value
STARR PLAYGROUND	1,value
STARS & STRIPES PLAYGROUND	3,value
STEBBINS PLAYGROUND	1,value
STEEPLECHASE PARK	1,value
STEINWAY PLAYGROUND	2,value
STERNBERG PARK	8,value
STOCKTON PLAYGROUND	1,value
STORY PLAYGROUND	1,value
STRAUS PARK	1,value
STRIPPOLI SQUARE	1,value
STROUD PLAYGROUND	3,value
STUYVESANT SQUARE	14,value
SUMNER PLAYGROUND	6,value
SUNRISE PLAYGROUND	1,value
SUNSET PARK	51,value
SUNSHINE PLAYGROUND	1,value
SURF PLAYGROUND	3,value
TAAFFE PLAYGROUND	1,value
TANAHEY PLAYGROUND	2,value
TAPPEN PARK	5,value
TAYLOR PLAYGROUND	1,value
TEN EYCK PLAYGROUND	4,value
TEN EYCK PLAZA	2,value
TEPPER TRIANGLE	1,value
THE BACKYARD	1,value
THE CYCLONE	1,value
THE HIGH LINE	8,value
THE OLDE TOWNE OF FLUSHING BURIAL GROUND	1,value
THE PAINTER'S PLAYGROUND	1,value
THE PEARLY GATES	5,value
THOMAS GREENE PLAYGROUND	4,value
THOMAS JEFFERSON PARK	56,value
THOMAS PAINE PARK	1,value
THURSBY BASIN PARK	1,value
TIFFANY PLAYGROUND	3,value
TILDEN PLAYGROUND	6,value
TOAD HALL PLAYGROUND	1,value
TOMPKINS SQUARE PARK	72,value
TOMPKINSVILLE PARK	3,value
TONY DAPOLITO RECREATION CENTER	3,value
TORSNEY PLAYGROUND	4,value
TOTTENVILLE POOL	1,value
TRAVERS PARK	22,value
TREMONT PARK	51,value
TRIANGLE AT E175TH STREET	1,value
TRIBECA PARK	1,value
TRINITY PARK	1,value
TUDOR PARK	2,value
TWENTY-FOUR SYCAMORES PARK	1,value
TWO COVES COMMUNITY GARDEN	1,value
UNDERHILL PLAYGROUND	3,value
UNION SQUARE PARK	85,value
UNIVERSITY MALLS	1,value
UNIVERSITY WOODS	5,value
UNNAMED PARK ON 3RD AVENUE	1,value
UNNAMED PARK ON 43RD AVENUE	2,value
UNNAMED PARK ON 4TH AVENUE	1,value
UNNAMED PARK ON 51ST ROAD	1,value
UNNAMED PARK ON BEACH CHANNEL DRIVE & BEACH 89TH TO OLD BEACH 88TH STREET	2,value
UNNAMED PARK ON BELT PARKWAY	2,value
UNNAMED PARK ON BERRIMAN STREET	1,value
UNNAMED PARK ON BRUCKNER EXPRESSWAY & ZEREGA AVENUE	1,value
UNNAMED PARK ON BRUCKNER EXPRESSWAY WEST OF MORRISON AVENUE	5,value
UNNAMED PARK ON CROSS BRONX EXPRESSWAY & ANTHONY AVENUE	1,value
UNNAMED PARK ON CROSS BRONX EXPRESSWAY & ARTHUR AVENUE TO BELMONT AVENUE	2,value
UNNAMED PARK ON CROSS BRONX EXPRESSWAY & FEATHERBED LANE	1,value
UNNAMED PARK ON CROSS BRONX EXPRESSWAY SERVICE RD & ROSEDALE AVENUE	1,value
UNNAMED PARK ON E 102ND STREET	3,value
UNNAMED PARK ON E 120TH STREET	3,value
UNNAMED PARK ON E 122ND STREET	1,value
UNNAMED PARK ON E 164TH STREET	1,value
UNNAMED PARK ON E 170TH STREET	1,value
UNNAMED PARK ON E 175TH STREET	1,value
UNNAMED PARK ON E 177TH STREET	2,value
UNNAMED PARK ON FETHERBED LANE	1,value
UNNAMED PARK ON GOWANUS EXPRESSWAY 63RD STREET TO 86TH STREET	1,value
UNNAMED PARK ON GRAND AVENUE	2,value
UNNAMED PARK ON HICKS STREET	1,value
UNNAMED PARK ON JAY STREET	1,value
UNNAMED PARK ON NELSON AVENUE	2,value
UNNAMED PARK ON PROSPECT EXPRESSWAY BETWEEN 3RD AVENUE & 7TH AVENUE	1,value
UNNAMED PARK ON RIVERSIDE DRIVE	16,value
UNNAMED PARK ON SOUNDVIEW AVENUE	2,value
UNNAMED PARK ON SUMMIT AVENUE	4,value
UNNAMED PARK ON THE SOUTHSIDE OF E 175TH STREET	1,value
UNNAMED PARK ON VAN WYCK EXPRESSWAY	1,value
UNNAMED PARK ON WEST MOUNT EDEN AVENUE	1,value
VAN ALST PLAYGROUND	3,value
VAN CORTLANDT PARK	114,value
VAN CORTLANDT'S TAIL	1,value
VAN DYKE PLAYGROUND	3,value
VERDI SQUARE	3,value
VESUVIO PLAYGROUND	2,value
VETERANS PARK QUEENS	1,value
VETERANS PARK STATEN ISLAND	2,value
VIDALIA PARK	4,value
VINMONT VETERAN PARK	1,value
VLADECK PARK	2,value
VLEIGH PLAYGROUND	2,value
VON BRIESEN PARK	1,value
WAGNER HOUSES POOL	1,value
WAGNER PLAYGROUND	2,value
WAKEFIELD PLAYGROUND	1,value
WALD PLAYGROUND	2,value
WALTER WARD PLAYGROUND	1,value
WALTON PARK	2,value
WARDS ISLAND PARK	4,value
WASHINGTON HALL PARK	6,value
WASHINGTON MARKET PARK	1,value
WASHINGTON PARK BRONX	1,value
WASHINGTON PARK BROOKLYN	3,value
WASHINGTON SQUARE PARK	100,value
WASHINGTON'S WALK	12,value
WATSON GLEASON PLAYGROUND	20,value
WEBSTER PLAYGROUND	3,value
WEST 4TH STREET COURTS	2,value
WEST PLAYGROUND	5,value
WESTERLEIGH PARK	1,value
WHALEN PARK	3,value
WHITE PLAYGROUND MANHATTAN	3,value
WILLIAMSBRIDGE OVAL	62,value
WILLIS PLAYGROUND	14,value
WILLOWBROOK PARK	2,value
WILSON PLAYGROUND	1,value
WINFIELD PLAZA	1,value
WINGATE PARK	18,value
WNYC TRANSMITTER PARK	3,value
WOOD PARK	1,value
WOODRUFF PLAYGROUND	2,value
WRIGHT BROTHERS PLAYGROUND	1,value
YAK PLAYGROUND	1,value
YELLOWSTONE PARK	1,value
ZIMMERMAN PLAYGROUND	7,value
ZION TRIANGLE	2,value
string	5101222,dtype
name	5101222,stype
NULL	5093623,label
VALID	7599,label
